Aprinoia	Aprinoia
Celleron Therapeutics Limited	
Crianza Aviation Ltd.	Crianza Aviation Ltd.
GROUND Inc.	GROUND Inc.
GS Inima	GS Inima
Intelon Optics	Intelon Optics
Ma San Group	Ma San Group	
마산그룹	마산그룹
Oncorus	Oncorus
OrthoSensor Inc.	OrthoSensor Inc.
Petrini 2 Ltd	Petrini 2 Ltd
Petrini Ltd.	Petrini Ltd.
PSI International, Inc.	PSI International, Inc.
사운더블헬스	사운더블헬스
Soundable health Inc	Soundable health Inc
Vin Group	Vin Group
빈그룹	빈그룹
강동냉장	강동냉장
단추를끓인수프	단추를끓인수프
고스트키친	고스트키친
그린에너지	그린에너지
글로벌네트웍스	글로벌네트웍스	
미트박스	미트박스
글로우데이즈	글로우데이즈
나진산업	나진산업
넥스트바이오메디컬	넥스트바이오메디컬
넥스틴	넥스틴
다나에너지솔루션	다나에너지솔루션
다이노나	다이노나
달리자		달리자
대원씨엔엠	대원씨엔엠
더웨일게임즈	더웨일게임즈
드림마크원	드림마크원
디에스파워	디에스파워
디자인하우스	디자인하우스
레이니스트	레이니스트
루닛	루닛
뤼이드	뤼이드
르솔레이	르솔레이
립코	립코
마이리얼트립	마이리얼트립
메콕스큐어메드	메콕스큐어메드
모코플렉스	모코플렉스
무신사	무신사
미나미시마바라 제일 발전소	미시마바라 제일 발전소
미띵스	미띵스
미래원	미래원
미래파인켐	미래파인켐
바이오에너지팜아산	바이오에너지팜아산
립코	립코
배틀엔터테인먼트	배틀엔터테인먼트
밸런스히어로	밸런스히어로
베이글코드	베이글코드
본아이에프	본아이에프
본죽	본죽
부산신항국제터미널	부산신항국제터미널
브레이브모바일	브레이브모바일
브릿지바이오테라퓨틱스	브릿지바이오테라퓨틱스
블리스팩	블리스팩
비노텍	비노텍
셀리드	셀리드
셀트리온스킨큐어	셀트리온스킨큐어
솔라커넥트	솔라커넥트
브레이브모바일	브레이브모바일
숨고	숨고
스타일쉐어	스타일쉐어
스파크바이오파마	스파크바이오파마
스피쿠스	스피쿠스
신대한정유산업	신대한정유산업
쓰리디컨트롤즈	쓰리디컨트롤즈
씨아이이에프	씨아이이에프
씨엔씨티에너지	씨엔씨티에너지
아이디어스	아이디어스
백패커	백패커
아이씨엠	아이씨엠
아이씨티케이홀딩스	아이씨티케이홀딩스
아이오바이오	아이오바이오
알파코리아	알파코리아
에스맥	에스맥
에스와이탱크터미널	에스와이탱크터미널
에스제이그룹	에스제이그룹
에스티에코	에스티에코
에스피엠탈로스	에스피엠탈로스
에이블씨엔씨	에이블씨엔씨
미샤	미샤
에이비엘바이오	에이비엘바이오
에이스토리	에이스토리
에코매니지먼트코리아홀딩스	에코매니지먼트코리아홀딩스
에코에너지코리아	에코에너지코리아
에프앤피	에프앤피
엑소스템텍	엑소스템텍
엔젠바이오	엔젠바이오
엠에프씨	엠에프씨
오늘의집	오늘의집
오름테라퓨틱	오름테라퓨틱
오하임아이엔티	오하임아이엔티
온상	온상
올리패스	올리패스
올리패스코스메슈티컬즈	올리패스코스메슈티컬즈
원더홀딩스	원더홀딩스
위메프	위메프
이도	이도
이엘피	이엘피
이엠케이승경	이엠케이승경
이엠케이울산	이엠케이울산
이클리어인터내셔날	이클리어인터내셔날
이피에스바이오	이피에스바이오
인카금융서비스	인카금융서비스
인텍바이오	인텍바이오
전진바이오팜	전진바이오팜
제니스월드	제니스월드
젝시믹스	젝시믹스
지누스	지누스
지앤비에스엔지니어링	지앤비에스엔지니어링
충남도시가스	충남도시가스
카비	카비
케이옥션	케이옥션
켄코아에어로스페이스	켄코아에어로스페이스
코애귤런트테라퓨틱스	코애귤런트테라퓨틱스
코코모	코코모
퀄슨	퀄슨
큐라코	큐라코
큐리옥스	큐리옥스
크라클팩토리	크라클팩토리
크래프톤	크래프톤
배틀그라운드	배틀그라운드
크몽	크몽
탑선	탑선
터크앤컴퍼니	터크앤컴퍼니
헬로마켓	헬로마켓
툴젠	툴젠
트렌비	트렌비
티움바이오	티움바이오
티지오테크	티지오테크
파로스아이비티	파로스아이비티
파멥신	파멥신
이피에스솔루션	이피에스솔루션
팜양주	팜양주
팜에이트	팜에이트
미래원	미래원
패스트캠퍼스	패스트캠퍼스
패스트파이브	패스트파이브
펨트론	펨트론
포인트모바일	포인트모바일
피에스에이 현대부산신항만	피에스에이 현대부산신항만
현대LNG해운	현대LNG해운
